{
  "width": 10,
  "height": 10,
  "layers": [
    {
      "data": [
        [177, 177, 177, 178, 163, 163, 163, 176, 177, 177],
        [177, 177, 177, 178, 163, 163, 163, 176, 177, 177],
        [177, 177, 177, 178, 16, 17, 18, 176, 177, 177],
        [177, 0, 1, 1, 65, 17, 64, 1, 2, 177],
        [177, 16, 17, 17, 17, 17, 17, 17, 18, 177],
        [177, 16, 17, 17, 17, 17, 17, 17, 18, 177],
        [177, 32, 33, 33, 33, 33, 33, 49, 18, 177],
        [177, 0, 1, 1, 1, 1, 1, 65, 18, 177],
        [177, 16, 48, 33, 33, 33, 33, 33, 34, 177],
        [177, 16, 18, 177, 177, 177, 177, 177, 177, 177]
      ]
    },
    {
      "data": [
        [-1, -1, -1, -1, 179, 180, 181, -1, -1, -1],
        [-1, -1, -1, -1, 195, 196, 197, -1, -1, -1],
        [-1, -1, -1, -1, 211, 212, 213, -1, -1, -1],
        [-1, -1, -1, -1, -1, -1, -1, -1, -1, -1],
        [-1, -1, -1, -1, -1, -1, -1, -1, -1, -1],
        [-1, -1, -1, -1, -1, -1, -1, -1, -1, -1],
        [-1, -1, -1, -1, -1, -1, -1, -1, -1, -1],
        [-1, -1, -1, -1, -1, -1, -1, -1, -1, -1],
        [-1, -1, -1, -1, -1, -1, -1, -1, -1, -1],
        [-1, -1, -1, -1, -1, -1, -1, -1, -1, -1]
      ]
    }
  ]
}
