{
  "width": 10,
  "height": 10,
  "layers": [
    {
      "data": [
        [177, 177, 177, 177, 49, 17, 48, 177, 177, 177],
        [177, 177, 177, 177, 16, 17, 18, 177, 177, 177],
        [177, 177, 177, 177, 16, 17, 18, 177, 177, 177],
        [177, 177, 177, 177, 16, 17, 18, 177, 177, 177],
        [177, 177, 177, 177, 16, 17, 18, 177, 177, 177],
        [177, 177, 177, 177, 16, 17, 18, 177, 177, 177],
        [177, 177, 177, 177, 16, 17, 18, 177, 177, 177],
        [177, 177, 177, 177, 65, 17, 64, 177, 177, 177],
        [177, 177, 177, 177, 163, 163, 163, 177, 177, 177],
        [177, 177, 177, 177, 163, 163, 163, 177, 177, 177]
      ]
    },
    {
      "data": [
        [-1, -1, -1, -1, -1, -1, -1, -1, -1, -1],
        [-1, -1, -1, -1, -1, -1, -1, -1, -1, -1],
        [-1, -1, -1, -1, -1, -1, -1, -1, -1, -1],
        [-1, -1, -1, -1, -1, -1, -1, -1, -1, -1],
        [-1, -1, -1, -1, -1, -1, -1, -1, -1, -1],
        [-1, -1, -1, -1, -1, -1, -1, -1, -1, -1],
        [-1, -1, -1, -1, -1, -1, -1, -1, -1, -1],
        [-1, -1, -1, -1, 179, 180, 181, -1, -1, -1],
        [-1, -1, -1, -1, 195, 196, 197, -1, -1, -1],
        [-1, -1, -1, -1, 211, 212, 213, -1, -1, -1]
      ]
    }
  ]
}