{
  "width": 10,
  "height": 10,
  "layers": [
    {
      "data": [
        [177, 177, 177, 177, 177, 177, 177, 177, 177, 177],
        [177, 177, 177, 177, 177, 177, 177, 177, 177, 177],
        [177, 177, 177, 177, 177, 177, 177, 177, 177, 177],
        [177, 177, 0, 1, 1, 1, 1, 2, 177, 177],
        [177, 177, 16, 17, 17, 17, 17, 18, 177, 177],
        [177, 177, 16, 17, 17, 17, 17, 18, 177, 177],
        [177, 177, 32, 49, 17, 17, 48, 34, 177, 177],
        [177, 177, 177, 16, 17, 17, 18, 177, 177, 177],
        [177, 177, 177, 16, 17, 17, 18, 177, 177, 177],
        [177, 177, 177, 16, 17, 17, 18, 177, 177, 177]
      ]
    },
    {
      "data": [
        [-1, -1, -1, 167, 168, -1, -1, -1, -1, -1],
        [-1, 137, 138, -1, -1, -1, -1, -1, -1, -1],
        [-1, 153, 154, -1, -1, -1, -1, -1, -1, -1],
        [-1, -1, -1, -1, -1, -1, -1, -1, -1, -1],
        [-1, -1, -1, -1, -1, -1, -1, -1, -1, -1],
        [-1, -1, -1, -1, -1, -1, -1, -1, -1, -1],
        [-1, -1, -1, -1, -1, -1, -1, -1, -1, -1],
        [-1, -1, -1, -1, -1, -1, -1, -1, -1, -1],
        [-1, -1, -1, -1, -1, -1, -1, -1, 164, -1],
        [-1, -1, -1, -1, -1, -1, -1, -1, 164, 164]
      ]
    }
  ]
}